






                                                                                                                                    
                                                                                                                                    
                                                   0      0                                                                         
                                                                                                                                    
                                            AAAAAAAAAAAAAAAAAAAAAAAAAAAAAAAAAAAAAAAAAAAA                                            
                                              AAAAAAAAAAAAAAAAAAAAAAAAAAAAAAAAAAAAAAAA                                              
                                                AAAAAAAAAAAAAAAAAAAAAAAAAAAAAAAAAAAA                                                
                                                  AAAAAAAAAAAAAAAAAAAAAAAAAAAAAAAA                                                  







